data,stato,codice_regione,denominazione_regione,lat,long,ricoverati_con_sintomi,terapia_intensiva,totale_ospedalizzati,isolamento_domiciliare,totale_positivi,variazione_totale_positivi,nuovi_positivi,dimessi_guariti,deceduti,casi_da_sospetto_diagnostico,casi_da_screening,totale_casi,tamponi,casi_testati,note,ingressi_terapia_intensiva,note_test,note_casi,totale_positivi_test_molecolare,totale_positivi_test_antigenico_rapido,tamponi_test_molecolare,tamponi_test_antigenico_rapido,codice_nuts_1,codice_nuts_2
2021-08-05T17:00:00,ITA,13,Abruzzo,42.35122196,13.39843823,38,1,39,1576,1615,81,123,72464,2515,,,76594,1864095,739721,,0,,,76594,0,1271623,592472,ITF,ITF1
2021-08-05T17:00:00,ITA,17,Basilicata,40.63947052,15.80514834,19,1,20,796,816,27,63,26202,592,,,27610,414093,219094,"Il numero totale dei decessi ne comprende n. 22 a carico di pazienti non residenti, deceduti in strutture ospedaliere della Regione Basilicata.",0,,,27610,0,394120,19973,ITF,ITF5
2021-08-05T17:00:00,ITA,18,Calabria,38.90597598,16.59440194,75,5,80,2449,2529,-218,164,67792,1265,,,71586,1004610,916123,,1,,"L’Asp di Reggio Calabria comunica che: “a seguito di verifiche effettuate si registrano n. 3 decessi  in RSA avvenuti uno in data  17/07/2021, uno  in data  18/07/2021 e uno  in data 04/08/2021). L’Asp di Crotone  comunica che dei 40 soggetti positivi di oggi 3 sono migranti.							 							 							 L’Asp di Reggio Calabria comunica che: “a seguito di verifiche effettuate si registrano n. 3 decessi  in RSA avvenuti uno in data  17/07/2021, uno  in data  18/07/2021 e uno  in data 04/08/2021)""					 							 L’Asp di Crotone  comunica che dei 40 soggetti positivi di oggi 3 sono migranti.							 							 							 ",71572,14,921972,82638,ITF,ITF6
2021-08-05T17:00:00,ITA,15,Campania,40.83956555,14.25084984,246,13,259,7569,7828,293,670,417728,7605,,,433161,5734969,3356640,1 deceduto in data 07.05.2021,1,,,421573,11588,4829285,905684,ITF,ITF3
2021-08-05T17:00:00,ITA,08,Emilia-Romagna,44.49436681,11.3417208,267,24,291,8711,9002,398,669,374717,13286,,,397005,7365147,1969558,"Sono stati eliminati 5 casi, positivi a test antigenico ma non confermati da tampone molecolare.",3,,,396654,351,5280494,2084653,ITH,ITH5
2021-08-05T17:00:00,ITA,06,Friuli Venezia Giulia,45.6494354,13.76813649,19,4,23,808,831,29,111,103821,3790,,,108442,2332684,721111,Il totale dei casi positivi è stato ridotto di 1 a seguito di un test positivo rimosso dopo revisione del caso (caso relativo alla provincia di Trieste),0,,"Si segnala, fra i casi odierni, la presenza di 8 migranti/richiedenti asilo in provincia di Trieste e 2 in provincia di Gorizia		",93739,14703,1910506,422178,ITH,ITH4
2021-08-05T17:00:00,ITA,12,Lazio,41.89277044,12.48366722,392,53,445,12104,12549,538,544,340049,8416,,,361014,8388310,4564368,"Si precisa che,  a causa della sospensione dei sistemi informatici a seguito di un attacco hacker al CED regionale, vengono aggiornati solo i dati relativi ai nuovi positivi, ai decessi ed  alle ospedalizzazioni. ",6,,,352007,9007,5221834,3166476,ITI,ITI4
2021-08-05T17:00:00,ITA,07,Liguria,44.41149315,8.9326992,40,13,53,1417,1470,129,169,100106,4366,,,105942,1946642,745813,"Si segnala che dei 169 nuovi positivi riscontrati in data odierna, n.2 soggetti sono rientrati dall'Albania in data 3/8; n.1 soggetto è rientrato dalla Spagna in data 3/8 e n.1 soggetto è rientrato dalla Regione Sardegna in data 3/8.",1,,In Regione Liguria la positività al test antigenico rapido è seguita da conferma con test molecolare,105942,0,1470688,475954,ITC,ITC3
2021-08-05T17:00:00,ITA,03,Lombardia,45.46679409,9.190347404,254,31,285,12048,12333,278,793,809835,33835,,,856003,12698582,4933885,,1,,,797765,58238,9924128,2774454,ITC,ITC4
2021-08-05T17:00:00,ITA,11,Marche,43.61675973,13.5188753,46,4,50,2398,2448,141,197,100798,3040,,,106286,1383114,806460,,0,,,106286,0,1225788,157326,ITI,ITI3
2021-08-05T17:00:00,ITA,14,Molise,41.55774754,14.65916051,2,1,3,126,129,-4,5,13341,492,,,13962,253535,220143,,0,,,13962,0,240505,13030,ITF,ITF2
2021-08-05T17:00:00,ITA,21,P.A. Bolzano,46.49933453,11.35662422,9,1,10,351,361,-12,21,72346,1184,,,73891,1735189,436357,21 nuovi positivi di cui 15 test antigenici confermati da test molecolare ,0,,,60659,13232,613466,1121723,ITH,ITH1
2021-08-05T17:00:00,ITA,22,P.A. Trento,46.06893511,11.12123097,10,1,11,362,373,-3,33,44792,1363,,,46528,921823,254229,,0,,,33039,13489,695580,226243,ITH,ITH2
2021-08-05T17:00:00,ITA,01,Piemonte,45.0732745,7.680687483,90,5,95,2774,2869,144,259,352252,11700,,,366821,5566025,2122442,,0,,,347649,19172,3226337,2339688,ITC,ITC1
2021-08-05T17:00:00,ITA,16,Puglia,41.12559576,16.86736689,95,13,108,2779,2887,158,243,247389,6671,,,256947,2946886,1303366,,2,,,255924,1023,2518978,427908,ITF,ITF4
2021-08-05T17:00:00,ITA,20,Sardegna,39.21531192,9.110616306,87,19,106,6000,6106,426,522,56009,1510,,,63625,1538450,893023,,2,,Si segnala il decesso dei paz.:  - 1 uomo 73 aa Residente nella Città Metropolitana di Cagliari  - 1 donna 80 aa Residente nella Città Metropolitana di Cagliari  - 1 donna 74 aa Residente nella Città Metropolitana di Cagliari  - 1 uomo 88 aa Residente nella Provincia del Sud Sardegna ,63559,66,1067090,471360,ITG,ITG2
2021-08-05T17:00:00,ITA,19,Sicilia,38.11569725,13.3623567,362,40,402,12145,12547,452,831,227637,6067,,,246251,5340028,2021313,,5,,,246251,0,2808947,2531081,ITG,ITG1
2021-08-05T17:00:00,ITA,09,Toscana,43.76923077,11.25588885,201,22,223,8869,9092,551,765,238967,6924,,,254983,5545466,2538176,,2,,,251181,3802,4092215,1453251,ITI,ITI1
2021-08-05T17:00:00,ITA,10,Umbria,43.10675841,12.38824698,18,2,20,1838,1858,86,147,55578,1424,,,58860,1605815,410881,"Si fa presente che 1 dei ricoveri NON UTI, non rientrano nei codici disciplina COVID e pertanto vengono collocati in ""Altra Struttura""",0,,,58860,0,1030216,575599,ITI,ITI2
2021-08-05T17:00:00,ITA,02,Valle d'Aosta,45.73750286,7.320149366,4,0,4,96,100,9,13,11248,473,,,11821,151955,72159,,0,,,11102,719,103913,48042,ITC,ITC2
2021-08-05T17:00:00,ITA,05,Veneto,45.43490485,12.33845213,135,15,150,13153,13303,323,888,414908,11645,,,439856,9695454,1954277,,1,,,426875,12981,6063281,3632173,ITH,ITH3
