data,stato,codice_regione,denominazione_regione,lat,long,ricoverati_con_sintomi,terapia_intensiva,totale_ospedalizzati,isolamento_domiciliare,totale_positivi,variazione_totale_positivi,nuovi_positivi,dimessi_guariti,deceduti,casi_da_sospetto_diagnostico,casi_da_screening,totale_casi,tamponi,casi_testati,note,ingressi_terapia_intensiva,note_test,note_casi,totale_positivi_test_molecolare,totale_positivi_test_antigenico_rapido,tamponi_test_molecolare,tamponi_test_antigenico_rapido,codice_nuts_1,codice_nuts_2
2021-06-29T17:00:00,ITA,13,Abruzzo,42.35122196,13.39843823,25,1,26,874,900,-93,30,71380,2512,,,74792,1693241,689244,,0,,,74792,0,1185802,507439,ITF,ITF1
2021-06-29T17:00:00,ITA,17,Basilicata,40.63947052,15.80514834,18,0,18,654,672,-105,7,25678,590,,,26940,392734,210604," Il numero totale dei decessi ne comprende n. 22 a carico di pazienti non residenti, deceduti in strutture ospedaliere della Regione Basilicata.",0,,,26940,0,375224,17510,ITF,ITF5
2021-06-29T17:00:00,ITA,18,Calabria,38.90597598,16.59440194,68,6,74,5213,5287,-158,25,62426,1224,,,68937,930258,853319,,0,,Dei 25 positivi di oggi 9 sono migranti comunicati dall'Asp di Reggio Calabria ,68923,14,870574,59684,ITF,ITF6
2021-06-29T17:00:00,ITA,15,Campania,40.83956555,14.25084984,209,21,230,8048,8278,-306,117,408442,7472,,,424192,5274911,3270670,"A seguito delle periodiche verifiche, dopo un accurato e dettagliato controllo da parte delle ASL, si sono riscontrati n°22 deceduti ascrivibili ad un periodo compreso tra Novembre 2020 e Maggio 2021, dei quali nessuno è deceduto nelle ultime 48 ore .",1,,,412604,11588,4583280,691631,ITF,ITF3
2021-06-29T17:00:00,ITA,08,Emilia-Romagna,44.49436681,11.3417208,194,27,221,3055,3276,-196,36,370254,13261,,,386791,6707402,1907497,"Sono stati eliminati 2 casi, positivi a test antigenico ma non confermati da tampone molecolare.",1,,,386470,321,4991140,1716262,ITH,ITH5
2021-06-29T17:00:00,ITA,06,Friuli Venezia Giulia,45.6494354,13.76813649,10,0,10,192,202,-13,16,102939,3789,,,106930,2153227,681155,,0,,"Si segnala, fra i casi odierni, la presenza di 2 migranti in provincia di Trieste. 2 casi precedentemente segnalati come casi confermati positivi al tampone molecolare, dopo verifica, sono stati riclassificati come casi positivi al tampone antigenico.",92450,14480,1794047,359180,ITH,ITH4
2021-06-29T17:00:00,ITA,12,Lazio,41.89277044,12.48366722,191,54,245,2995,3240,-86,46,334345,8329,,,345914,7606520,4447506,,0,,,337382,8532,4949206,2657314,ITI,ITI4
2021-06-29T17:00:00,ITA,07,Liguria,44.41149315,8.9326992,18,7,25,125,150,-9,17,98922,4351,,,103423,1754927,683616,"Si comunica che dei 17 casi confermati in data odierna, 11 soggetti sono membri dell’equipaggio della nave battente bandiera tunisina “Tanit”.",0,,In Regione Liguria la positività al test antigenico rapido è seguita da conferma con test ,103423,0,1371866,383061,ITC,ITC3
2021-06-29T17:00:00,ITA,03,Lombardia,45.46679409,9.190347404,248,52,300,10902,11202,-23,98,796716,33778,,,841696,11556788,4593092,,2,,,787638,54058,9369560,2187228,ITC,ITC4
2021-06-29T17:00:00,ITA,11,Marche,43.61675973,13.5188753,21,4,25,1318,1343,-29,8,99246,3036,,,103625,1297684,761811,,0,,,103625,0,1156060,141624,ITI,ITI3
2021-06-29T17:00:00,ITA,14,Molise,41.55774754,14.65916051,8,0,8,77,85,-3,0,13141,491,,,13717,240640,207358,,0,,,13717,0,227610,13030,ITF,ITF2
2021-06-29T17:00:00,ITA,21,P.A. Bolzano,46.49933453,11.35662422,6,3,9,150,159,-5,8,71960,1180,,,73299,1636890,427370,8 nuovi positivi di cui 3 test antigenici confermati da test molecolare ,0,,,60067,13232,594645,1042245,ITH,ITH1
2021-06-29T17:00:00,ITA,22,P.A. Trento,46.06893511,11.12123097,5,0,5,57,62,-2,4,44339,1362,,,45763,866862,232244,,0,,,32784,12979,680589,186273,ITH,ITH2
2021-06-29T17:00:00,ITA,01,Piemonte,45.0732745,7.680687483,162,14,176,724,900,-93,31,350298,11696,,,362894,4986305,1977341,,0,,,344179,18715,3056225,1930080,ITC,ITC1
2021-06-29T17:00:00,ITA,16,Puglia,41.12559576,16.86736689,131,15,146,2977,3123,-349,59,243541,6642,,,253306,2668808,1236521,,3,,"E' stata effettuata una riclassificazione di alcuni casi confermati da test antigenico, che sono risultati successivamente anche confermati da test molecolare e quindi ricompresi tra questi",252401,905,2388988,279820,ITF,ITF4
2021-06-29T17:00:00,ITA,20,Sardegna,39.21531192,9.110616306,31,3,34,2288,2322,-16,11,53406,1491,,,57219,1378824,804728,,0,,Si segnala il decesso del pz: - 1 donna 84 aa residente nella Città Metropolitana di Cagliari,57202,17,961074,417750,ITG,ITG2
2021-06-29T17:00:00,ITA,19,Sicilia,38.11569725,13.3623567,162,24,186,4041,4227,-125,99,221360,5967,,,231554,4889132,1853917,,1,,,231554,0,2639308,2249824,ITG,ITG1
2021-06-29T17:00:00,ITA,09,Toscana,43.76923077,11.25588885,98,28,126,1846,1972,-143,18,235401,6864,,,244237,5126271,2356561,,0,,,240744,3493,3859419,1266852,ITI,ITI1
2021-06-29T17:00:00,ITA,10,Umbria,43.10675841,12.38824698,17,3,20,759,779,2,8,54647,1419,,,56845,1456323,390816,,0,,,56845,0,970136,486187,ITI,ITI2
2021-06-29T17:00:00,ITA,02,Valle d'Aosta,45.73750286,7.320149366,1,0,1,36,37,2,3,11178,473,,,11688,139636,66289,,0,,,11015,673,100455,39181,ITC,ITC2
2021-06-29T17:00:00,ITA,05,Veneto,45.43490485,12.33845213,53,8,61,4547,4608,-108,38,409148,11615,,,425371,8640807,1821567,Nei valori riportati per le terapie intensive si è verificato un disallineamento temporale del flusso informativo pertanto per convenzione è stato riportato  2 dimessi da TI  invece del n. 1 effettivi che include anche i negativizzati. ,1,,,413489,11882,5647246,2993561,ITH,ITH3
