data,stato,codice_regione,denominazione_regione,lat,long,ricoverati_con_sintomi,terapia_intensiva,totale_ospedalizzati,isolamento_domiciliare,totale_positivi,variazione_totale_positivi,nuovi_positivi,dimessi_guariti,deceduti,casi_da_sospetto_diagnostico,casi_da_screening,totale_casi,tamponi,casi_testati,note,ingressi_terapia_intensiva,note_test,note_casi,totale_positivi_test_molecolare,totale_positivi_test_antigenico_rapido,tamponi_test_molecolare,tamponi_test_antigenico_rapido,codice_nuts_1,codice_nuts_2
2021-09-05T17:00:00,ITA,13,Abruzzo,42.35122196,13.39843823,83,5,88,2205,2293,100,101,74765,2533,,,79591,2073529,807748,,0,,,79591,0,1346284,727245,ITF,ITF1
2021-09-05T17:00:00,ITA,17,Basilicata,40.63947052,15.80514834,45,3,48,1388,1436,13,34,27164,600,,,29200,443138,230599,"Il numero totale dei decessi ne comprende n. 22 a carico di pazienti non residenti, deceduti in strutture ospedaliere della Regione Basilicata.",0,,,29200,0,421735,21403,ITF,ITF5
2021-09-05T17:00:00,ITA,18,Calabria,38.90597598,16.59440194,176,13,189,5053,5242,106,264,72653,1333,,,79228,1101860,995333,"L'Asp di Catanzaro comunica: ""oggi 2 nuovi positivi di cui 1 fuori regione - un decesso in T.I. dell'AOU Mater Domini appartenente all'ASP di Vibo Valentia"".								 L'Asp di Cosenza comunica: ""Oggi si registrano 123 nuovi casi di cui 2 residenti fuori regione"".								 L' Asp di Crotone  comunica: ""Oggi 4 nuovi positivi e due migranti guariti."" L' Asp di Reggio Calabria  comunica: ""Nr. 2 decessi di cui 1 Terapia Intensiva""							",0,,,79214,14,990041,111819,ITF,ITF6
2021-09-05T17:00:00,ITA,15,Campania,40.83956555,14.25084984,369,31,400,8488,8888,-57,394,431280,7779,,,447947,6190658,3452421,,7,,A seguito delle verifiche delle AA.SS.LL. si evince che 9 deceduti registrati in data odierna sono riconducibili ad un periodo compreso tra Marzo e Maggio 2021,436359,11588,5043644,1147014,ITF,ITF3
2021-09-05T17:00:00,ITA,08,Emilia-Romagna,44.49436681,11.3417208,391,51,442,15147,15589,-1050,497,385576,13383,,,414548,8139110,2032090,"Sono stati eliminati 1 casi, positivi a test antigenico ma non confermati da tampone molecolare.",4,,,414187,361,5575954,2563156,ITH,ITH5
2021-09-05T17:00:00,ITA,06,Friuli Venezia Giulia,45.6494354,13.76813649,43,15,58,1315,1373,-10,95,106345,3805,,,111523,2523676,766243,,1,,"Si segnala, fra i casi odierni, la presenza di 9 migranti/richiedenti asilo in provincia di Trieste.",96444,15079,2024070,499606,ITH,ITH4
2021-09-05T17:00:00,ITA,12,Lazio,41.89277044,12.48366722,449,63,512,13477,13989,-146,417,354127,8542,,,376658,8593816,4589295,,2,,,367651,9007,5286280,3307536,ITI,ITI4
2021-09-05T17:00:00,ITA,07,Liguria,44.41149315,8.9326992,72,8,80,1992,2072,10,109,104062,4387,,,110521,2150765,814499,*di cui 7 reinfezioni a partire dal 3/09/2021 [circ. min sal. n.37911 del 20/08/2021]. ,0,,In Regione Liguria la positività al test antigenico rapido è seguita da conferma con test molecolare ,110521,0,1562218,588547,ITC,ITC3
2021-09-05T17:00:00,ITA,03,Lombardia,45.46679409,9.190347404,365,58,423,11009,11432,203,404,827301,33933,,,872666,13795578,5208240,,3,,,810512,62154,10338318,3457260,ITC,ITC4
2021-09-05T17:00:00,ITA,11,Marche,43.61675973,13.5188753,60,22,82,3425,3507,21,139,104834,3051,,,111392,1465676,852337,,0,,,111392,0,1289152,176524,ITI,ITI3
2021-09-05T17:00:00,ITA,14,Molise,41.55774754,14.65916051,13,0,13,244,257,24,31,13601,495,,,14353,264699,231109,,0,,,14353,0,251669,13030,ITF,ITF2
2021-09-05T17:00:00,ITA,21,P.A. Bolzano,46.49933453,11.35662422,28,5,33,832,865,57,74,73369,1186,,,75420,1919162,463076,74 nuovi positivi di cui 25 test antigenici confermati da test molecolare,1,,,62188,13232,633512,1285650,ITH,ITH1
2021-09-05T17:00:00,ITA,22,P.A. Trento,46.06893511,11.12123097,18,0,18,449,467,-9,25,45819,1366,,,47652,1016501,292100,,0,,,33404,14248,708879,307622,ITH,ITH2
2021-09-05T17:00:00,ITA,01,Piemonte,45.0732745,7.680687483,164,22,186,3680,3866,11,173,358192,11724,,,373782,6116540,2273697,,2,,,353900,19882,3364967,2751573,ITC,ITC1
2021-09-05T17:00:00,ITA,16,Puglia,41.12559576,16.86736689,226,20,246,4072,4318,-5,156,253743,6722,,,264783,3356534,1378845,,0,,,263586,1197,2654102,702432,ITF,ITF4
2021-09-05T17:00:00,ITA,20,Sardegna,39.21531192,9.110616306,231,27,258,6455,6713,-99,144,64921,1593,,,73227,1732498,981339,,2,,Si segnala il decesso dei paz.:  - 1 uomo 79 aa Residente nella Provincia di Nuoro  - 1 donna 49 aa Residente nella Città Metropolitana di Cagliari  - 1 uomo 69 aa Residente nella Città Metropolitana di Cagliari ,73123,104,1173432,559066,ITG,ITG2
2021-09-05T17:00:00,ITA,19,Sicilia,38.11569725,13.3623567,845,120,965,27497,28462,177,1024,247552,6445,,,282459,5863437,2237410,DECEDUTI: N. 4 IL 04/09/21 - N. 5 IL 03/09/21 - N. 1 IL 02/09/21 ,10,,,282459,0,3030279,2833158,ITG,ITG1
2021-09-05T17:00:00,ITA,09,Toscana,43.76923077,11.25588885,392,58,450,10502,10952,77,557,256008,7031,,,273991,5976155,2719105,,4,,,269594,4397,4348231,1627924,ITI,ITI1
2021-09-05T17:00:00,ITA,10,Umbria,43.10675841,12.38824698,48,7,55,1619,1674,-1,101,59164,1434,,,62272,1784672,427614,"Si fa presente che 2 dei ricoveri NON UTI, non rientrano nei codici disciplina COVID e pertanto viene collocato in ""Altra Struttura"".",0,,,62272,0,1087526,697146,ITI,ITI2
2021-09-05T17:00:00,ITA,02,Valle d'Aosta,45.73750286,7.320149366,0,0,0,97,97,-3,3,11464,473,,,12034,170361,81561,,0,,,11239,795,106799,63562,ITC,ITC2
2021-09-05T17:00:00,ITA,05,Veneto,45.43490485,12.33845213,198,44,242,12968,13210,244,573,433283,11700,,,458193,10841638,2034156,Nei valori riportati per le terapie intensive si è verificato un disallineamento temporale del flusso informativo pertanto per convenzione è stato riportato  4 dimessi da TI  invece del n. 3 effettivi che include anche i negativizzati.,1,,,444371,13822,6410734,4430904,ITH,ITH3
