data,stato,codice_regione,denominazione_regione,lat,long,ricoverati_con_sintomi,terapia_intensiva,totale_ospedalizzati,isolamento_domiciliare,totale_positivi,variazione_totale_positivi,nuovi_positivi,dimessi_guariti,deceduti,casi_da_sospetto_diagnostico,casi_da_screening,totale_casi,tamponi,casi_testati,note,ingressi_terapia_intensiva,note_test,note_casi,totale_positivi_test_molecolare,totale_positivi_test_antigenico_rapido,tamponi_test_molecolare,tamponi_test_antigenico_rapido,codice_nuts_1,codice_nuts_2
2021-08-15T17:00:00,ITA,13,Abruzzo,42.35122196,13.39843823,56,5,61,1971,2032,62,76,72985,2518,,,77535,1928957,763162,Dal totale dei positivi è stato eliminato un caso in quanto già seguito in altro stato.			 ,1,,,77535,0,1293428,635529,ITF,ITF1
2021-08-15T17:00:00,ITA,17,Basilicata,40.63947052,15.80514834,32,2,34,1092,1126,52,63,26383,594,,,28103,422636,222537,"Il numero totale dei decessi ne comprende n. 22 a carico di pazienti non residenti, deceduti in strutture ospedaliere della Regione Basilicata.",1,,,28103,0,402091,20545,ITF,ITF5
2021-08-15T17:00:00,ITA,18,Calabria,38.90597598,16.59440194,103,7,110,3365,3475,18,250,68954,1275,,,73704,1033841,940441,,0,,,73690,14,942284,91557,ITF,ITF6
2021-08-15T17:00:00,ITA,15,Campania,40.83956555,14.25084984,313,15,328,8847,9175,217,473,421431,7640,,,438246,5885705,3392358,,0,,,426658,11588,4895110,990595,ITF,ITF3
2021-08-15T17:00:00,ITA,08,Emilia-Romagna,44.49436681,11.3417208,326,35,361,12787,13148,166,551,376702,13300,,,403150,7608348,1989478,"Sono stati eliminati 2 casi, positivi a test antigenico ma non confermati da tampone molecolare.",3,,,402799,351,5373255,2235093,ITH,ITH5
2021-08-15T17:00:00,ITA,06,Friuli Venezia Giulia,45.6494354,13.76813649,30,5,35,866,901,-13,61,104619,3792,,,109312,2389704,734895,,1,,"Si segnala, fra i casi odierni, la presenza di 3 migranti/richiedenti asilo in provincia di Trieste.",94499,14813,1953255,436449,ITH,ITH4
2021-08-15T17:00:00,ITA,12,Lazio,41.89277044,12.48366722,456,67,523,18007,18530,466,467,340049,8441,,,367020,8388310,4564368,"Si precisa che,  a causa della sospensione dei sistemi informatici a seguito di un attacco hacker al CED regionale, vengono aggiornati solo i dati relativi ai nuovi positivi, ai decessi ed  alle ospedalizzazioni. ",2,,,358013,9007,5221834,3166476,ITI,ITI4
2021-08-15T17:00:00,ITA,07,Liguria,44.41149315,8.9326992,71,12,83,1698,1781,4,169,101286,4370,,,107437,2012385,770898,,0,,In Regione Liguria la positività al test antigenico rapido è seguita da conferma con test molecolare,107437,0,1499150,513235,ITC,ITC3
2021-08-15T17:00:00,ITA,03,Lombardia,45.46679409,9.190347404,308,42,350,12881,13231,11,333,814814,33857,,,861902,13026827,5020500,,7,,,802367,59535,10059845,2966982,ITC,ITC4
2021-08-15T17:00:00,ITA,11,Marche,43.61675973,13.5188753,39,6,45,2927,2972,48,160,101989,3043,,,108004,1410581,822311,,0,,,108004,0,1246734,163847,ITI,ITI3
2021-08-15T17:00:00,ITA,14,Molise,41.55774754,14.65916051,8,1,9,151,160,7,21,13416,492,,,14068,256826,223379,,0,,,14068,0,243796,13030,ITF,ITF2
2021-08-15T17:00:00,ITA,21,P.A. Bolzano,46.49933453,11.35662422,18,1,19,511,530,-1,22,72546,1184,,,74260,1793431,445040,,0,,22 nuovi positivi di cui 3 test antigenici confermati da test molecolare		 ,61028,13232,619376,1174055,ITH,ITH1
2021-08-15T17:00:00,ITA,22,P.A. Trento,46.06893511,11.12123097,19,1,20,427,447,29,47,45087,1363,,,46897,951856,266242,,0,,,33156,13741,699364,252492,ITH,ITH2
2021-08-15T17:00:00,ITA,01,Piemonte,45.0732745,7.680687483,115,9,124,3320,3444,101,202,353896,11705,,,369045,5738585,2170840,,2,,,349639,19406,3268674,2469911,ITC,ITC1
2021-08-15T17:00:00,ITA,16,Puglia,41.12559576,16.86736689,128,22,150,4058,4208,101,184,248792,6682,,,259682,3079519,1327713,,2,,,258626,1056,2560291,519228,ITF,ITF4
2021-08-15T17:00:00,ITA,20,Sardegna,39.21531192,9.110616306,134,21,155,7135,7290,37,275,58216,1532,,,67038,1596184,921482,,1,,Si segnala il decesso dei paz.:  - 1 uomo 50 aa Residente nella Provincia di Oristano  - 1 uomo 77 aa Residente nella Città Metropolitana di Cagliari  - 1 uomo 69 aa Residente nella Città Metropolitana di Cagliari  - 1 donna 84 aa Residente nella Città Metropolitana di Cagliari  - 1 uomo 90 aa Residente nella Città Metropolitana di Cagliari,66955,83,1100870,495314,ITG,ITG2
2021-08-15T17:00:00,ITA,19,Sicilia,38.11569725,13.3623567,538,68,606,17430,18036,549,946,231294,6141,,,255471,5489876,2080136,,3,,,255471,0,2869022,2620854,ITG,ITG1
2021-08-15T17:00:00,ITA,09,Toscana,43.76923077,11.25588885,287,33,320,12061,12381,192,725,242645,6950,,,261976,5684712,2599444,,2,,,257939,4037,4177228,1507484,ITI,ITI1
2021-08-15T17:00:00,ITA,10,Umbria,43.10675841,12.38824698,33,2,35,2170,2205,-35,117,56481,1426,,,60112,1664886,416846,"Si fa presente che 1 dei ricoveri NON UTI, non rientrano nei codici disciplina COVID e pertanto vengono collocati in ""Altra Struttura"".",0,,,60112,0,1049865,615021,ITI,ITI2
2021-08-15T17:00:00,ITA,02,Valle d'Aosta,45.73750286,7.320149366,4,0,4,122,126,7,13,11307,473,,,11906,158175,75703,,0,,,11160,746,104873,53302,ITC,ITC2
2021-08-15T17:00:00,ITA,05,Veneto,45.43490485,12.33845213,144,30,174,13156,13330,44,509,420817,11654,,,445801,10085559,1985142,Nei valori riportati per le terapie intensive si è verificato un disallineamento temporale del flusso informativo pertanto per convenzione è stato riportato  1 dimessi da TI  invece del n. 3 effettivi che include anche i negativizzati.,4,,,432576,13225,6183427,3902132,ITH,ITH3
